12
-1 -1           -1 -1 -1 -1 -1 -1 -1 -1 -1 -1
-1  2147483647   0  0 -1  0 -1  0  0  0  0 -1
-1  0           -1  0 -1  0 -1 -1  0 -1  0 -1
-1 -1           -1  0 -1  0  0  0  0 -1  0 -1
-1  0            0  0  0 -1 -1 -1  0 -1  0 -2147483648
-1  0           -1 -1  0 -1  0 -1  0 -1  0 -1
-1  0            0 -1  0 -1  0 -1  0 -1  0 -1
-1 -1            0 -1  0 -1  0 -1  0 -1  0 -1
-1  0            0  0  0  0  0  0  0 -1  0 -1
-1 -1           -1  0 -1 -1  0 -1 -1 -1  0 -1
-1  0            0  0  0  0  0  0  0  0  0 -1
-1 -1           -1 -1 -1 -1 -1 -1 -1 -1 -1 -1